1111111111112111111111111
1000000000002000000000001
1000000000002000000000001
1000000000002000000000001
1000000000002000000000001
1000000000002000000000001
1000000000002000000000001
1000000000002000000000001
1000000000002000000000001
1000000000002000000000001
1000000000002000000000001
1000000000002000000000001
2222222222222222222222222
1000000000002000000000001
1000000000002000000000001
1000000000002000000000001
1000000000002000000000001
1000000000002000000000001
1000000000002000000000001
1000000000002000000000001
1000000000002000000000001
1000000000002000000000001
1000000000002000000000001
1000000000002000000000001
1111111111112111111111111